X X X X X X X X X X X X X X X X X X X X X X 
X 1 1 1 1 1 1 1 1 1 1 1 1 1 1 1 1 1 1 1 1 X 
X 1 1 1 1 1 1 1 1 1 1 1 1 1 1 1 1 1 1 1 1 X 
X 1 1 1 1 1 1 1 1 1 1 1 1 1 1 1 0 0 0 0 E X 
X 1 1 1 1 1 1 1 1 1 1 1 1 1 1 1 0 1 1 1 0 X 
X 1 1 1 1 1 1 1 1 1 1 1 1 1 0 0 0 0 0 1 0 X 
X 1 1 1 1 1 1 1 1 1 1 1 1 1 0 1 0 1 1 1 E X 
X 1 1 1 1 1 1 1 1 1 1 1 1 1 0 0 0 0 0 0 0 X 
X 1 1 1 1 1 1 1 E 0 0 0 0 0 0 0 0 0 0 0 0 X 
X 1 1 1 1 1 1 1 1 1 1 1 1 1 0 0 0 0 0 0 0 X 
X 1 1 1 1 1 1 1 0 0 0 0 0 0 0 0 0 0 0 1 0 X 
X 1 1 1 1 1 1 1 0 1 1 1 1 1 0 0 0 1 1 1 0 X 
X 1 1 1 1 1 1 1 0 1 1 1 1 1 0 0 0 1 1 1 0 X 
X 1 1 1 1 1 1 1 0 0 0 0 0 0 0 0 0 0 0 0 0 X 
X 1 1 1 1 1 1 1 1 0 0 1 1 1 0 0 0 1 1 1 0 X 
X 1 1 1 1 1 1 1 1 0 0 1 1 1 0 0 0 1 1 1 0 X 
X 1 1 1 1 1 1 1 1 0 0 0 0 1 0 0 0 0 0 0 0 X 
X 1 1 1 1 1 1 1 1 0 0 1 P 1 0 0 0 1 1 1 0 X 
X 1 1 0 0 0 0 0 0 0 0 0 0 0 0 0 0 1 1 1 0 X 
X 1 1 0 1 1 1 1 1 0 0 1 0 1 0 0 0 0 0 0 0 X 
X 1 1 0 0 0 0 0 0 0 0 0 0 0 0 0 0 0 0 0 0 X 
X X X X X X X X X X X X X X X X X X X X X X 
